5
8
########
#      S
### # ##
###    E
########